site_name: QWC2 - @version@
docs_dir: src
nav:
    - QWC2:
        - Home: index.md
        - Quick start: QuickStart.md
        - General configuration:
            - Themes: configuration/ThemesConfiguration.md
            - Viewer: configuration/ViewerConfiguration.md
            - Resources and permissions: configuration/ResourcesPermissions.md
            - Services: configuration/ServiceConfiguration.md
        - Selected topics:
            - Search: topics/Search.md
            - Feature info: topics/FeatureInfo.md
            - Printing: topics/Printing.md
            - Map export: topics/MapExport.md
            - Map info: topics/Mapinfo.md
            - Editing: topics/Editing.md
            - Snapping: topics/Snapping.md
            - Temporal layers: topics/TimeManager.md
            - Tour Guide: topics/TourGuide.md
            - Legend graphics: topics/LegendGraphics.md
            - Map filtering: topics/MapFilter.md
            - Reports: topics/Reports.md
            - Interfacing with applications: topics/Interfacing.md
            - Multi-tenancy: topics/MultiTenancy.md
        - References: references/index.md
        - Version history:
            - ChangeLog: release_notes/ChangeLog.md
            - QWC2 upgrade notes: release_notes/QWC2UpgradeNotes.md
            - qwc-docker upgrade notes: release_notes/QwcDockerUpgradeNotes.md
        - User guide: UserGuide.md
        - FAQ: FAQ.md

theme:
    name: readthedocs
    include_homepage_in_sidebar: true
extra_css:
    - css/custom.css
markdown_extensions:
  - toc:
      permalink: true
